sr_thullium_gray	sr_thullium_gray
sr_sorium_3_gray	sr_sorium_3_gray
sr_magnetite_gray	sr_magnetite_gray
sr_xerodine_gray	sr_xerodine_gray
sr_hyperfuels_gray	sr_hyperfuels_gray
sr_scritch_gray	sr_scritch_gray
sr_prismatic_crystals_gray	sr_prismatic_crystals_gray
sr_hyper_diamond_gray	sr_hyper_diamond_gray
sr_helium_gray	sr_helium_gray
sr_cavorite_gray	sr_cavorite_gray
sr_illum_gray	sr_illum_gray
sr_ex_terraform_gases_gray	sr_ex_terraform_gases_gray
sr_ex_terraform_liquids_gray	sr_ex_terraform_liquids_gray
sr_ex_zro_gray	sr_ex_zro_gray
sr_ex_living_metal_gray	sr_ex_living_metal_gray
sr_ex_yuranic_gray	sr_ex_yuranic_gray
sr_ex_teldar_gray	sr_ex_teldar_gray
sr_ex_orillium_gray	sr_ex_orillium_gray
sr_ex_neutronium_gray	sr_ex_neutronium_gray
sr_ex_garanthium_gray	sr_ex_garanthium_gray
sr_ex_lythuric_gray	sr_ex_lythuric_gray
sr_ex_dark_matter_gray	sr_ex_dark_matter_gray
