sr_rare_metals	sr_rare_metals
sr_chromium	sr_chromium
sr_zinorine	sr_zinorine
sr_lithium	sr_lithium
sr_hivaron_stone	sr_hivaron_stone
sr_archeological_remains	sr_archeological_remains
sr_smartmetal	sr_smartmetal
sr_precursor_nanites	sr_precursor_nanites
sr_iron_wood	sr_iron_wood
sr_biofuels	sr_biofuels
sr_exotic_spices	sr_exotic_spices
sr_ventium	sr_ventium
sr_hellamit	sr_hellamit
sr_terraforming_bacteria	sr_terraforming_bacteria
sr_ex_pitharan	sr_ex_pitharan
sr_ex_engos	sr_ex_engos
sr_ex_satramene	sr_ex_satramene
sr_ex_alien_pets	sr_ex_alien_pets
sr_ex_betharian	sr_ex_betharian
sr_elder_compounds	sr_elder_compounds
sr_thorium	sr_thorium
sr_gigalife	sr_gigalife
sr_precursor_data_cache	sr_precursor_data_cache
sr_euratite	sr_euratite
sr_aurantiacum_x	sr_aurantiacum_x
sr_ever_blossom	sr_ever_blossom
