sr_rare_metals_gray	sr_rare_metals_gray
sr_chromium_gray	sr_chromium_gray
sr_zinorine_gray	sr_zinorine_gray
sr_lithium_gray	sr_lithium_gray
sr_hivaron_stone_gray	sr_hivaron_stone_gray
sr_archeological_remains_gray	sr_archeological_remains_gray
sr_smartmetal_gray	sr_smartmetal_gray
sr_precursor_nanites_gray	sr_precursor_nanites_gray
sr_iron_wood_gray	sr_iron_wood_gray
sr_biofuels_gray	sr_biofuels_gray
sr_exotic_spices_gray	sr_exotic_spices_gray
sr_ventium_gray	sr_ventium_gray
sr_hellamit_gray	sr_hellamit_gray
sr_terraforming_bacteria_gray	sr_terraforming_bacteria_gray
sr_ex_pitharan_gray	sr_ex_pitharan_gray
sr_ex_engos_gray	sr_ex_engos_gray
sr_ex_satramene_gray	sr_ex_satramene_gray
sr_ex_alien_pets_gray	sr_ex_alien_pets_gray
sr_ex_betharian_gray	sr_ex_betharian_gray
sr_elder_compounds_gray	sr_elder_compounds_gray
sr_thorium_gray	sr_thorium_gray
sr_gigalife_gray	sr_gigalife_gray
sr_precursor_data_cache_gray	sr_precursor_data_cache_gray
sr_euratite_gray	sr_euratite_gray
sr_aurantiacum_x_gray	sr_aurantiacum_x_gray
sr_ever_blossom_gray	sr_ever_blossom_gray
